~~~~~~~~~~~~~~~~~~~~~~~~~~~~
~~~~~~~~~~~~~~~~~~~~~~~~~~~~
~~~~~~~~~~~~~~~~~~~~~~~~~~~~
#############~~#############
#[..........#~~#..........]#
#.######.##.#~~#.##.######.#
#.######.##.####.##.######.#
#........##......##........#
##.#####.##########.#####.##
##.#####.##########.#####.##
...##..................##...
##.##.####.######.####.##.##
##.##.####.######.####.##.##
#..........######..........#
#.###.###....1.....###.###.#
#.###.###.###==###.###.###.#
~.........#~~4~~~#.........~
###.#####.#2~~~~~#.#####.###
~~#.#####.#~~~~3~#.#####.#~~
###.#####.########.#####.###
~........0~~~~~~~~~........~
#.########.######.########.#
#.########.######.########.#
#.##....................##.#
#.##.###.###.##.###.###.##.#
#.##.###.###.##.###.###.##.#
#.##....................##.#
#....###.##########.###....#
#.##.###.##########.###.##.#
#.##....................##.#
#.#########.####.#########.#
#.#########.#~~#.#########.#
#]..........#~~#..........[#
#############~~#############
~~~~~~~~~~~~~~~~~~~~~~~~~~~~
~~~~~~~~~~~~~~~~~~~~~~~~~~~~